"filename", "language", "YAML", "scs", "Markdown", "comment", "blank", "total"
"/mnt/dev/development/ostis/study/ostis/gt/.github/ISSUE_TEMPLATE/формализация-раздела.md", "Markdown", 0, 0, 14, 0, 5, 19
"/mnt/dev/development/ostis/study/ostis/gt/.github/workflows/update-scs.yml", "YAML", 18, 0, 0, 0, 3, 21
"/mnt/dev/development/ostis/study/ostis/gt/Graphs/Acyclic Graphs/Forests/concept_conditional_inference_forest.scs", "scs", 0, 45, 0, 0, 10, 55
"/mnt/dev/development/ostis/study/ostis/gt/Graphs/Acyclic Graphs/Forests/concept_decision_forest.scs", "scs", 0, 64, 0, 0, 15, 79
"/mnt/dev/development/ostis/study/ostis/gt/Graphs/Acyclic Graphs/Forests/concept_extra_trees_forest.scs", "scs", 0, 59, 0, 0, 14, 73
"/mnt/dev/development/ostis/study/ostis/gt/Graphs/Acyclic Graphs/Forests/concept_forest.scs", "scs", 0, 121, 0, 0, 29, 150
"/mnt/dev/development/ostis/study/ostis/gt/Graphs/Acyclic Graphs/Forests/concept_polyforest.scs", "scs", 0, 60, 0, 0, 15, 75
"/mnt/dev/development/ostis/study/ostis/gt/Graphs/Acyclic Graphs/Forests/concept_pseudoforest.scs", "scs", 0, 23, 0, 0, 7, 30
"/mnt/dev/development/ostis/study/ostis/gt/Graphs/Acyclic Graphs/Forests/concept_random_forest.scs", "scs", 0, 55, 0, 0, 14, 69
"/mnt/dev/development/ostis/study/ostis/gt/Graphs/Acyclic Graphs/Forests/conditional_inference_forest.concept.yaml", "YAML", 35, 0, 0, 0, 3, 38
"/mnt/dev/development/ostis/study/ostis/gt/Graphs/Acyclic Graphs/Forests/decision_forest.concept.yaml", "YAML", 51, 0, 0, 0, 4, 55
"/mnt/dev/development/ostis/study/ostis/gt/Graphs/Acyclic Graphs/Forests/domain_forests.scs", "scs", 0, 41, 0, 0, 9, 50
"/mnt/dev/development/ostis/study/ostis/gt/Graphs/Acyclic Graphs/Forests/extra_trees_forest.concept.yaml", "YAML", 46, 0, 0, 0, 4, 50
"/mnt/dev/development/ostis/study/ostis/gt/Graphs/Acyclic Graphs/Forests/forest.concept.yaml", "YAML", 86, 0, 0, 0, 8, 94
"/mnt/dev/development/ostis/study/ostis/gt/Graphs/Acyclic Graphs/Forests/forests.domain.yaml", "YAML", 12, 0, 0, 0, 4, 16
"/mnt/dev/development/ostis/study/ostis/gt/Graphs/Acyclic Graphs/Forests/polyforest.concept.yaml", "YAML", 41, 0, 0, 0, 4, 45
"/mnt/dev/development/ostis/study/ostis/gt/Graphs/Acyclic Graphs/Forests/pseudoforest.concept.yaml", "YAML", 14, 0, 0, 0, 2, 16
"/mnt/dev/development/ostis/study/ostis/gt/Graphs/Acyclic Graphs/Forests/random_forest.concept.yaml", "YAML", 42, 0, 0, 0, 4, 46
"/mnt/dev/development/ostis/study/ostis/gt/Graphs/Acyclic Graphs/Trees/Binary Trees/binary_search_tree.concept.yaml", "YAML", 20, 0, 0, 0, 2, 22
"/mnt/dev/development/ostis/study/ostis/gt/Graphs/Acyclic Graphs/Trees/Binary Trees/binary_tree.concept.yaml", "YAML", 48, 0, 0, 0, 4, 52
"/mnt/dev/development/ostis/study/ostis/gt/Graphs/Acyclic Graphs/Trees/Binary Trees/binary_trees.domain.yaml", "YAML", 10, 0, 0, 0, 4, 14
"/mnt/dev/development/ostis/study/ostis/gt/Graphs/Acyclic Graphs/Trees/Binary Trees/concept_binary_search_tree.scs", "scs", 0, 29, 0, 0, 9, 38
"/mnt/dev/development/ostis/study/ostis/gt/Graphs/Acyclic Graphs/Trees/Binary Trees/concept_binary_tree.scs", "scs", 0, 58, 0, 0, 14, 72
"/mnt/dev/development/ostis/study/ostis/gt/Graphs/Acyclic Graphs/Trees/Binary Trees/concept_matrix_tree.scs", "scs", 0, 37, 0, 0, 10, 47
"/mnt/dev/development/ostis/study/ostis/gt/Graphs/Acyclic Graphs/Trees/Binary Trees/domain_binary_trees.scs", "scs", 0, 34, 0, 0, 11, 45
"/mnt/dev/development/ostis/study/ostis/gt/Graphs/Acyclic Graphs/Trees/Binary Trees/matrix_tree.concept.yaml", "YAML", 20, 0, 0, 0, 2, 22
"/mnt/dev/development/ostis/study/ostis/gt/Graphs/Acyclic Graphs/Trees/Heaps/binary_heap.concept.yaml", "YAML", 21, 0, 0, 0, 3, 24
"/mnt/dev/development/ostis/study/ostis/gt/Graphs/Acyclic Graphs/Trees/Heaps/biparental_heap.concept.yaml", "YAML", 26, 0, 0, 0, 3, 29
"/mnt/dev/development/ostis/study/ostis/gt/Graphs/Acyclic Graphs/Trees/Heaps/concept_binary_heap.scs", "scs", 0, 41, 0, 0, 11, 52
"/mnt/dev/development/ostis/study/ostis/gt/Graphs/Acyclic Graphs/Trees/Heaps/concept_biparental_heap.scs", "scs", 0, 39, 0, 0, 10, 49
"/mnt/dev/development/ostis/study/ostis/gt/Graphs/Acyclic Graphs/Trees/Heaps/concept_d_ary_heap.scs", "scs", 0, 39, 0, 0, 10, 49
"/mnt/dev/development/ostis/study/ostis/gt/Graphs/Acyclic Graphs/Trees/Heaps/concept_fibonacci_heap.scs", "scs", 0, 21, 0, 0, 7, 28
"/mnt/dev/development/ostis/study/ostis/gt/Graphs/Acyclic Graphs/Trees/Heaps/concept_heap.scs", "scs", 0, 44, 0, 0, 12, 56
"/mnt/dev/development/ostis/study/ostis/gt/Graphs/Acyclic Graphs/Trees/Heaps/concept_leftist_heap.scs", "scs", 0, 24, 0, 0, 8, 32
"/mnt/dev/development/ostis/study/ostis/gt/Graphs/Acyclic Graphs/Trees/Heaps/concept_max_heap.scs", "scs", 0, 35, 0, 0, 10, 45
"/mnt/dev/development/ostis/study/ostis/gt/Graphs/Acyclic Graphs/Trees/Heaps/concept_min_heap.scs", "scs", 0, 35, 0, 0, 10, 45
"/mnt/dev/development/ostis/study/ostis/gt/Graphs/Acyclic Graphs/Trees/Heaps/d_ary_heap.concept.yaml", "YAML", 23, 0, 0, 0, 2, 25
"/mnt/dev/development/ostis/study/ostis/gt/Graphs/Acyclic Graphs/Trees/Heaps/domain_heaps.scs", "scs", 0, 44, 0, 0, 9, 53
"/mnt/dev/development/ostis/study/ostis/gt/Graphs/Acyclic Graphs/Trees/Heaps/fibonacci_heap.concept.yaml", "YAML", 13, 0, 0, 0, 2, 15
"/mnt/dev/development/ostis/study/ostis/gt/Graphs/Acyclic Graphs/Trees/Heaps/heap.concept.yaml", "YAML", 32, 0, 0, 0, 4, 36
"/mnt/dev/development/ostis/study/ostis/gt/Graphs/Acyclic Graphs/Trees/Heaps/heaps.domain.yaml", "YAML", 13, 0, 0, 0, 4, 17
"/mnt/dev/development/ostis/study/ostis/gt/Graphs/Acyclic Graphs/Trees/Heaps/leftist_heap.concept.yaml", "YAML", 15, 0, 0, 0, 1, 16
"/mnt/dev/development/ostis/study/ostis/gt/Graphs/Acyclic Graphs/Trees/Heaps/max_heap.concept.yaml", "YAML", 23, 0, 0, 0, 3, 26
"/mnt/dev/development/ostis/study/ostis/gt/Graphs/Acyclic Graphs/Trees/Heaps/min_heap.concept.yaml", "YAML", 23, 0, 0, 0, 3, 26
"/mnt/dev/development/ostis/study/ostis/gt/Graphs/Acyclic Graphs/Trees/Quad Trees/concept_polygonal_map_quadtree.scs", "scs", 0, 36, 0, 0, 11, 47
"/mnt/dev/development/ostis/study/ostis/gt/Graphs/Acyclic Graphs/Trees/Quad Trees/concept_quadtree.scs", "scs", 0, 97, 0, 0, 24, 121
"/mnt/dev/development/ostis/study/ostis/gt/Graphs/Acyclic Graphs/Trees/Quad Trees/domain_quadtrees.scs", "scs", 0, 26, 0, 0, 9, 35
"/mnt/dev/development/ostis/study/ostis/gt/Graphs/Acyclic Graphs/Trees/Quad Trees/polygonal_map_quadtree.concept.yaml", "YAML", 25, 0, 0, 0, 3, 28
"/mnt/dev/development/ostis/study/ostis/gt/Graphs/Acyclic Graphs/Trees/Quad Trees/quadtree.concept.yaml", "YAML", 65, 0, 0, 0, 6, 71
"/mnt/dev/development/ostis/study/ostis/gt/Graphs/Acyclic Graphs/Trees/Quad Trees/quadtrees.domain.yaml", "YAML", 7, 0, 0, 0, 4, 11
"/mnt/dev/development/ostis/study/ostis/gt/Graphs/Acyclic Graphs/Trees/cartesian_tree.concept.yaml", "YAML", 31, 0, 0, 0, 1, 32
"/mnt/dev/development/ostis/study/ostis/gt/Graphs/Acyclic Graphs/Trees/concept_cartesian_tree.scs", "scs", 0, 33, 0, 0, 9, 42
"/mnt/dev/development/ostis/study/ostis/gt/Graphs/Acyclic Graphs/Trees/concept_cover_tree.scs", "scs", 0, 54, 0, 0, 11, 65
"/mnt/dev/development/ostis/study/ostis/gt/Graphs/Acyclic Graphs/Trees/concept_dancing_tree.scs", "scs", 0, 50, 0, 0, 11, 61
"/mnt/dev/development/ostis/study/ostis/gt/Graphs/Acyclic Graphs/Trees/concept_decision_tree.scs", "scs", 0, 53, 0, 0, 10, 63
"/mnt/dev/development/ostis/study/ostis/gt/Graphs/Acyclic Graphs/Trees/concept_descartes_tree.scs", "scs", 0, 32, 0, 0, 9, 41
"/mnt/dev/development/ostis/study/ostis/gt/Graphs/Acyclic Graphs/Trees/concept_fenwick_tree.scs", "scs", 0, 69, 0, 0, 12, 81
"/mnt/dev/development/ostis/study/ostis/gt/Graphs/Acyclic Graphs/Trees/concept_fibonacci_tree.scs", "scs", 0, 56, 0, 0, 11, 67
"/mnt/dev/development/ostis/study/ostis/gt/Graphs/Acyclic Graphs/Trees/concept_growing_tree.scs", "scs", 0, 52, 0, 0, 11, 63
"/mnt/dev/development/ostis/study/ostis/gt/Graphs/Acyclic Graphs/Trees/concepts/aa_tree.concept.yaml", "YAML", 58, 0, 0, 0, 3, 61
"/mnt/dev/development/ostis/study/ostis/gt/Graphs/Acyclic Graphs/Trees/concepts/avl_tree.concept.yaml", "YAML", 348, 0, 0, 0, 11, 359
"/mnt/dev/development/ostis/study/ostis/gt/Graphs/Acyclic Graphs/Trees/concepts/b_tree.concept.yaml", "YAML", 48, 0, 0, 0, 5, 53
"/mnt/dev/development/ostis/study/ostis/gt/Graphs/Acyclic Graphs/Trees/concepts/balanced_tree.concept.yaml", "YAML", 47, 0, 0, 0, 4, 51
"/mnt/dev/development/ostis/study/ostis/gt/Graphs/Acyclic Graphs/Trees/concepts/bicentre_tree.concept.yaml", "YAML", 33, 0, 0, 0, 3, 36
"/mnt/dev/development/ostis/study/ostis/gt/Graphs/Acyclic Graphs/Trees/concepts/bichromatic_graph.concept.yaml", "YAML", 25, 0, 0, 0, 4, 29
"/mnt/dev/development/ostis/study/ostis/gt/Graphs/Acyclic Graphs/Trees/concepts/binomial_tree.concept.yaml", "YAML", 64, 0, 0, 0, 4, 68
"/mnt/dev/development/ostis/study/ostis/gt/Graphs/Acyclic Graphs/Trees/concepts/brother_tree.concept.yaml", "YAML", 57, 0, 0, 0, 4, 61
"/mnt/dev/development/ostis/study/ostis/gt/Graphs/Acyclic Graphs/Trees/concepts/bsp_tree.concept.yaml", "YAML", 40, 0, 0, 0, 3, 43
"/mnt/dev/development/ostis/study/ostis/gt/Graphs/Acyclic Graphs/Trees/concepts/concept_aa_tree.scs", "scs", 0, 53, 0, 0, 12, 65
"/mnt/dev/development/ostis/study/ostis/gt/Graphs/Acyclic Graphs/Trees/concepts/concept_avl_tree.scs", "scs", 0, 255, 0, 0, 44, 299
"/mnt/dev/development/ostis/study/ostis/gt/Graphs/Acyclic Graphs/Trees/concepts/concept_b_tree.scs", "scs", 0, 47, 0, 0, 14, 61
"/mnt/dev/development/ostis/study/ostis/gt/Graphs/Acyclic Graphs/Trees/concepts/concept_balanced_tree.scs", "scs", 0, 56, 0, 0, 14, 70
"/mnt/dev/development/ostis/study/ostis/gt/Graphs/Acyclic Graphs/Trees/concepts/concept_bicentre_tree.scs", "scs", 0, 47, 0, 0, 12, 59
"/mnt/dev/development/ostis/study/ostis/gt/Graphs/Acyclic Graphs/Trees/concepts/concept_bichromatic_graph.scs", "scs", 0, 43, 0, 0, 13, 56
"/mnt/dev/development/ostis/study/ostis/gt/Graphs/Acyclic Graphs/Trees/concepts/concept_binomial_tree.scs", "scs", 0, 79, 0, 0, 16, 95
"/mnt/dev/development/ostis/study/ostis/gt/Graphs/Acyclic Graphs/Trees/concepts/concept_brother_tree.scs", "scs", 0, 69, 0, 0, 16, 85
"/mnt/dev/development/ostis/study/ostis/gt/Graphs/Acyclic Graphs/Trees/concepts/concept_bsp_tree.scs", "scs", 0, 44, 0, 0, 11, 55
"/mnt/dev/development/ostis/study/ostis/gt/Graphs/Acyclic Graphs/Trees/concepts/concept_hypertree.scs", "scs", 0, 113, 0, 0, 30, 143
"/mnt/dev/development/ostis/study/ostis/gt/Graphs/Acyclic Graphs/Trees/concepts/concept_irreducible_tree.scs", "scs", 0, 35, 0, 0, 10, 45
"/mnt/dev/development/ostis/study/ostis/gt/Graphs/Acyclic Graphs/Trees/concepts/concept_justified_tree.scs", "scs", 0, 62, 0, 0, 15, 77
"/mnt/dev/development/ostis/study/ostis/gt/Graphs/Acyclic Graphs/Trees/concepts/concept_k_d_tree.scs", "scs", 0, 62, 0, 0, 15, 77
"/mnt/dev/development/ostis/study/ostis/gt/Graphs/Acyclic Graphs/Trees/concepts/concept_leaf.scs", "scs", 0, 89, 0, 0, 20, 109
"/mnt/dev/development/ostis/study/ostis/gt/Graphs/Acyclic Graphs/Trees/concepts/concept_left_linear_tree.scs", "scs", 0, 40, 0, 0, 11, 51
"/mnt/dev/development/ostis/study/ostis/gt/Graphs/Acyclic Graphs/Trees/concepts/concept_minimum_spanning_tree.scs", "scs", 0, 42, 0, 0, 11, 53
"/mnt/dev/development/ostis/study/ostis/gt/Graphs/Acyclic Graphs/Trees/concepts/concept_multitree.scs", "scs", 0, 91, 0, 0, 24, 115
"/mnt/dev/development/ostis/study/ostis/gt/Graphs/Acyclic Graphs/Trees/concepts/concept_n_ary_tree.scs", "scs", 0, 42, 0, 0, 11, 53
"/mnt/dev/development/ostis/study/ostis/gt/Graphs/Acyclic Graphs/Trees/concepts/concept_octree.scs", "scs", 0, 42, 0, 0, 11, 53
"/mnt/dev/development/ostis/study/ostis/gt/Graphs/Acyclic Graphs/Trees/concepts/concept_ordered_tree.scs", "scs", 0, 30, 0, 0, 8, 38
"/mnt/dev/development/ostis/study/ostis/gt/Graphs/Acyclic Graphs/Trees/concepts/concept_perfectly_balanced_tree.scs", "scs", 0, 24, 0, 0, 8, 32
"/mnt/dev/development/ostis/study/ostis/gt/Graphs/Acyclic Graphs/Trees/concepts/concept_polytree.scs", "scs", 0, 46, 0, 0, 11, 57
"/mnt/dev/development/ostis/study/ostis/gt/Graphs/Acyclic Graphs/Trees/concepts/concept_r_tree.scs", "scs", 0, 35, 0, 0, 10, 45
"/mnt/dev/development/ostis/study/ostis/gt/Graphs/Acyclic Graphs/Trees/concepts/concept_radix_tree.scs", "scs", 0, 35, 0, 0, 10, 45
"/mnt/dev/development/ostis/study/ostis/gt/Graphs/Acyclic Graphs/Trees/concepts/concept_range_maximum_tree.scs", "scs", 0, 35, 0, 0, 10, 45
"/mnt/dev/development/ostis/study/ostis/gt/Graphs/Acyclic Graphs/Trees/concepts/concept_red_black_tree.scs", "scs", 0, 129, 0, 0, 34, 163
"/mnt/dev/development/ostis/study/ostis/gt/Graphs/Acyclic Graphs/Trees/concepts/concept_rooted_tree.scs", "scs", 0, 108, 0, 0, 18, 126
"/mnt/dev/development/ostis/study/ostis/gt/Graphs/Acyclic Graphs/Trees/concepts/concept_segment_tree.scs", "scs", 0, 40, 0, 0, 11, 51
"/mnt/dev/development/ostis/study/ostis/gt/Graphs/Acyclic Graphs/Trees/concepts/concept_self_balancing_search_tree.scs", "scs", 0, 26, 0, 0, 8, 34
"/mnt/dev/development/ostis/study/ostis/gt/Graphs/Acyclic Graphs/Trees/concepts/concept_sorting_tree.scs", "scs", 0, 114, 0, 0, 31, 145
"/mnt/dev/development/ostis/study/ostis/gt/Graphs/Acyclic Graphs/Trees/concepts/concept_spanning_tree.scs", "scs", 0, 28, 0, 0, 8, 36
"/mnt/dev/development/ostis/study/ostis/gt/Graphs/Acyclic Graphs/Trees/concepts/concept_star_tree.scs", "scs", 0, 40, 0, 0, 11, 51
"/mnt/dev/development/ostis/study/ostis/gt/Graphs/Acyclic Graphs/Trees/concepts/concept_subtree.scs", "scs", 0, 123, 0, 0, 28, 151
"/mnt/dev/development/ostis/study/ostis/gt/Graphs/Acyclic Graphs/Trees/concepts/concept_suffix_tree.scs", "scs", 0, 51, 0, 0, 14, 65
"/mnt/dev/development/ostis/study/ostis/gt/Graphs/Acyclic Graphs/Trees/concepts/concept_ternary_search_tree.scs", "scs", 0, 59, 0, 0, 16, 75
"/mnt/dev/development/ostis/study/ostis/gt/Graphs/Acyclic Graphs/Trees/concepts/concept_tree.scs", "scs", 0, 339, 0, 0, 61, 400
"/mnt/dev/development/ostis/study/ostis/gt/Graphs/Acyclic Graphs/Trees/concepts/concept_tree_depth.scs", "scs", 0, 48, 0, 0, 11, 59
"/mnt/dev/development/ostis/study/ostis/gt/Graphs/Acyclic Graphs/Trees/concepts/concept_tree_height.scs", "scs", 0, 52, 0, 0, 11, 63
"/mnt/dev/development/ostis/study/ostis/gt/Graphs/Acyclic Graphs/Trees/concepts/concept_tree_root.scs", "scs", 0, 24, 0, 0, 8, 32
"/mnt/dev/development/ostis/study/ostis/gt/Graphs/Acyclic Graphs/Trees/concepts/concept_trie.scs", "scs", 0, 37, 0, 0, 10, 47
"/mnt/dev/development/ostis/study/ostis/gt/Graphs/Acyclic Graphs/Trees/concepts/concept_two_three_tree.scs", "scs", 0, 45, 0, 0, 12, 57
"/mnt/dev/development/ostis/study/ostis/gt/Graphs/Acyclic Graphs/Trees/concepts/concept_undirected_tree.scs", "scs", 0, 24, 0, 0, 8, 32
"/mnt/dev/development/ostis/study/ostis/gt/Graphs/Acyclic Graphs/Trees/concepts/concept_van_emde_boas_tree.scs", "scs", 0, 45, 0, 0, 10, 55
"/mnt/dev/development/ostis/study/ostis/gt/Graphs/Acyclic Graphs/Trees/concepts/concept_vantage_point_tree.scs", "scs", 0, 37, 0, 0, 10, 47
"/mnt/dev/development/ostis/study/ostis/gt/Graphs/Acyclic Graphs/Trees/concepts/hypertree.concept.yaml", "YAML", 87, 0, 0, 0, 8, 95
"/mnt/dev/development/ostis/study/ostis/gt/Graphs/Acyclic Graphs/Trees/concepts/irreducible_tree.concept.yaml", "YAML", 19, 0, 0, 0, 2, 21
"/mnt/dev/development/ostis/study/ostis/gt/Graphs/Acyclic Graphs/Trees/concepts/justified_tree.concept.yaml", "YAML", 40, 0, 0, 0, 3, 43
"/mnt/dev/development/ostis/study/ostis/gt/Graphs/Acyclic Graphs/Trees/concepts/k_d_tree.concept.yaml", "YAML", 36, 0, 0, 0, 2, 38
"/mnt/dev/development/ostis/study/ostis/gt/Graphs/Acyclic Graphs/Trees/concepts/leaf.concept.yaml", "YAML", 63, 0, 0, 0, 5, 68
"/mnt/dev/development/ostis/study/ostis/gt/Graphs/Acyclic Graphs/Trees/concepts/left_linear_tree.concept.yaml", "YAML", 22, 0, 0, 0, 2, 24
"/mnt/dev/development/ostis/study/ostis/gt/Graphs/Acyclic Graphs/Trees/concepts/minimum_spanning_tree.concept.yaml", "YAML", 23, 0, 0, 0, 2, 25
"/mnt/dev/development/ostis/study/ostis/gt/Graphs/Acyclic Graphs/Trees/concepts/multitree.concept.yaml", "YAML", 71, 0, 0, 0, 6, 77
"/mnt/dev/development/ostis/study/ostis/gt/Graphs/Acyclic Graphs/Trees/concepts/n_ary_tree.concept.yaml", "YAML", 23, 0, 0, 0, 2, 25
"/mnt/dev/development/ostis/study/ostis/gt/Graphs/Acyclic Graphs/Trees/concepts/octree.concept.yaml", "YAML", 24, 0, 0, 0, 2, 26
"/mnt/dev/development/ostis/study/ostis/gt/Graphs/Acyclic Graphs/Trees/concepts/ordered_tree.concept.yaml", "YAML", 17, 0, 0, 0, 2, 19
"/mnt/dev/development/ostis/study/ostis/gt/Graphs/Acyclic Graphs/Trees/concepts/perfectly_balanced_tree.concept.yaml", "YAML", 11, 0, 0, 0, 2, 13
"/mnt/dev/development/ostis/study/ostis/gt/Graphs/Acyclic Graphs/Trees/concepts/polytree.concept.yaml", "YAML", 32, 0, 0, 0, 3, 35
"/mnt/dev/development/ostis/study/ostis/gt/Graphs/Acyclic Graphs/Trees/concepts/r_tree.concept.yaml", "YAML", 26, 0, 0, 0, 3, 29
"/mnt/dev/development/ostis/study/ostis/gt/Graphs/Acyclic Graphs/Trees/concepts/radix_tree.concept.yaml", "YAML", 23, 0, 0, 0, 3, 26
"/mnt/dev/development/ostis/study/ostis/gt/Graphs/Acyclic Graphs/Trees/concepts/range_maximum_tree.concept.yaml", "YAML", 27, 0, 0, 0, 3, 30
"/mnt/dev/development/ostis/study/ostis/gt/Graphs/Acyclic Graphs/Trees/concepts/red_black_tree.concept.yaml", "YAML", 108, 0, 0, 0, 9, 117
"/mnt/dev/development/ostis/study/ostis/gt/Graphs/Acyclic Graphs/Trees/concepts/rooted_tree.concept.yaml", "YAML", 88, 0, 0, 0, 5, 93
"/mnt/dev/development/ostis/study/ostis/gt/Graphs/Acyclic Graphs/Trees/concepts/segment_tree.concept.yaml", "YAML", 22, 0, 0, 0, 3, 25
"/mnt/dev/development/ostis/study/ostis/gt/Graphs/Acyclic Graphs/Trees/concepts/self_balancing_search_tree.concept.yaml", "YAML", 16, 0, 0, 0, 2, 18
"/mnt/dev/development/ostis/study/ostis/gt/Graphs/Acyclic Graphs/Trees/concepts/sorting_tree.concept.yaml", "YAML", 72, 0, 0, 0, 8, 80
"/mnt/dev/development/ostis/study/ostis/gt/Graphs/Acyclic Graphs/Trees/concepts/spanning_tree.concept.yaml", "YAML", 15, 0, 0, 0, 2, 17
"/mnt/dev/development/ostis/study/ostis/gt/Graphs/Acyclic Graphs/Trees/concepts/star_tree.concept.yaml", "YAML", 26, 0, 0, 0, 3, 29
"/mnt/dev/development/ostis/study/ostis/gt/Graphs/Acyclic Graphs/Trees/concepts/subtree.concept.yaml", "YAML", 98, 0, 0, 0, 7, 105
"/mnt/dev/development/ostis/study/ostis/gt/Graphs/Acyclic Graphs/Trees/concepts/suffix_tree.concept.yaml", "YAML", 37, 0, 0, 0, 4, 41
"/mnt/dev/development/ostis/study/ostis/gt/Graphs/Acyclic Graphs/Trees/concepts/ternary_search_tree.concept.yaml", "YAML", 44, 0, 0, 0, 4, 48
"/mnt/dev/development/ostis/study/ostis/gt/Graphs/Acyclic Graphs/Trees/concepts/tree.concept.yaml", "YAML", 260, 0, 0, 0, 16, 276
"/mnt/dev/development/ostis/study/ostis/gt/Graphs/Acyclic Graphs/Trees/concepts/tree_depth.concept.yaml", "YAML", 29, 0, 0, 0, 4, 33
"/mnt/dev/development/ostis/study/ostis/gt/Graphs/Acyclic Graphs/Trees/concepts/tree_height.concept.yaml", "YAML", 33, 0, 0, 0, 3, 36
"/mnt/dev/development/ostis/study/ostis/gt/Graphs/Acyclic Graphs/Trees/concepts/tree_root.concept.yaml", "YAML", 11, 0, 0, 0, 2, 13
"/mnt/dev/development/ostis/study/ostis/gt/Graphs/Acyclic Graphs/Trees/concepts/trie.concept.yaml", "YAML", 26, 0, 0, 0, 3, 29
"/mnt/dev/development/ostis/study/ostis/gt/Graphs/Acyclic Graphs/Trees/concepts/two_three_tree.concept.yaml", "YAML", 54, 0, 0, 0, 3, 57
"/mnt/dev/development/ostis/study/ostis/gt/Graphs/Acyclic Graphs/Trees/concepts/undirected_tree.concept.yaml", "YAML", 11, 0, 0, 0, 2, 13
"/mnt/dev/development/ostis/study/ostis/gt/Graphs/Acyclic Graphs/Trees/concepts/van_emde_boas_tree.concept.yaml", "YAML", 34, 0, 0, 0, 3, 37
"/mnt/dev/development/ostis/study/ostis/gt/Graphs/Acyclic Graphs/Trees/concepts/vantage_point_tree.concept.yaml", "YAML", 24, 0, 0, 0, 3, 27
"/mnt/dev/development/ostis/study/ostis/gt/Graphs/Acyclic Graphs/Trees/cover_tree.concept.yaml", "YAML", 52, 0, 0, 0, 1, 53
"/mnt/dev/development/ostis/study/ostis/gt/Graphs/Acyclic Graphs/Trees/dancing_tree.concept.yaml", "YAML", 46, 0, 0, 0, 1, 47
"/mnt/dev/development/ostis/study/ostis/gt/Graphs/Acyclic Graphs/Trees/decision_tree.concept.yaml", "YAML", 48, 0, 0, 0, 1, 49
"/mnt/dev/development/ostis/study/ostis/gt/Graphs/Acyclic Graphs/Trees/descartes_tree.concept.yaml", "YAML", 30, 0, 0, 0, 0, 30
"/mnt/dev/development/ostis/study/ostis/gt/Graphs/Acyclic Graphs/Trees/domain_trees.scs", "scs", 0, 206, 0, 0, 14, 220
"/mnt/dev/development/ostis/study/ostis/gt/Graphs/Acyclic Graphs/Trees/fenwick_tree.concept.yaml", "YAML", 66, 0, 0, 0, 1, 67
"/mnt/dev/development/ostis/study/ostis/gt/Graphs/Acyclic Graphs/Trees/fibonacci_tree.concept.yaml", "YAML", 68, 0, 0, 0, 1, 69
"/mnt/dev/development/ostis/study/ostis/gt/Graphs/Acyclic Graphs/Trees/growing_tree.concept.yaml", "YAML", 45, 0, 0, 0, 1, 46
"/mnt/dev/development/ostis/study/ostis/gt/Graphs/Acyclic Graphs/Trees/trees.domain.yaml", "YAML", 69, 0, 0, 0, 7, 76
"/mnt/dev/development/ostis/study/ostis/gt/Graphs/Acyclic Graphs/acyclic_graphs.domain.yaml", "YAML", 22, 0, 0, 0, 7, 29
"/mnt/dev/development/ostis/study/ostis/gt/Graphs/Acyclic Graphs/concepts/acyclic_graph.concept.yaml", "YAML", 30, 0, 0, 0, 4, 34
"/mnt/dev/development/ostis/study/ostis/gt/Graphs/Acyclic Graphs/concepts/concept_acyclic_graph.scs", "scs", 0, 46, 0, 0, 13, 59
"/mnt/dev/development/ostis/study/ostis/gt/Graphs/Acyclic Graphs/concepts/concept_dag.scs", "scs", 0, 67, 0, 0, 14, 81
"/mnt/dev/development/ostis/study/ostis/gt/Graphs/Acyclic Graphs/concepts/concept_dag_with_single_source_and_sink.scs", "scs", 0, 59, 0, 0, 14, 73
"/mnt/dev/development/ostis/study/ostis/gt/Graphs/Acyclic Graphs/concepts/concept_dag_with_sink.scs", "scs", 0, 49, 0, 0, 13, 62
"/mnt/dev/development/ostis/study/ostis/gt/Graphs/Acyclic Graphs/concepts/concept_dag_with_source.scs", "scs", 0, 47, 0, 0, 13, 60
"/mnt/dev/development/ostis/study/ostis/gt/Graphs/Acyclic Graphs/concepts/concept_dag_with_source_and_sink.scs", "scs", 0, 60, 0, 0, 13, 73
"/mnt/dev/development/ostis/study/ostis/gt/Graphs/Acyclic Graphs/concepts/concept_topological_sorting.scs", "scs", 0, 26, 0, 0, 8, 34
"/mnt/dev/development/ostis/study/ostis/gt/Graphs/Acyclic Graphs/concepts/dag.concept.yaml", "YAML", 50, 0, 0, 0, 4, 54
"/mnt/dev/development/ostis/study/ostis/gt/Graphs/Acyclic Graphs/concepts/dag_with_single_source_and_sink.concept.yaml", "YAML", 44, 0, 0, 0, 4, 48
"/mnt/dev/development/ostis/study/ostis/gt/Graphs/Acyclic Graphs/concepts/dag_with_sink.concept.yaml", "YAML", 37, 0, 0, 0, 4, 41
"/mnt/dev/development/ostis/study/ostis/gt/Graphs/Acyclic Graphs/concepts/dag_with_source.concept.yaml", "YAML", 36, 0, 0, 0, 4, 40
"/mnt/dev/development/ostis/study/ostis/gt/Graphs/Acyclic Graphs/concepts/dag_with_source_and_sink.concept.yaml", "YAML", 45, 0, 0, 0, 4, 49
"/mnt/dev/development/ostis/study/ostis/gt/Graphs/Acyclic Graphs/concepts/topological_sorting.concept.yaml", "YAML", 17, 0, 0, 0, 2, 19
"/mnt/dev/development/ostis/study/ostis/gt/Graphs/Acyclic Graphs/domain_acyclic_graphs.scs", "scs", 0, 66, 0, 0, 14, 80
"/mnt/dev/development/ostis/study/ostis/gt/Graphs/Directed Graphs/Weighted Directed Graphs/acyclic_weighted_directed_graph.concept.yaml", "YAML", 79, 0, 0, 0, 5, 84
"/mnt/dev/development/ostis/study/ostis/gt/Graphs/Directed Graphs/Weighted Directed Graphs/concept_acyclic_weighted_directed_graph.scs", "scs", 0, 99, 0, 0, 20, 119
"/mnt/dev/development/ostis/study/ostis/gt/Graphs/Directed Graphs/Weighted Directed Graphs/concept_rib_weight.scs", "scs", 0, 45, 0, 0, 12, 57
"/mnt/dev/development/ostis/study/ostis/gt/Graphs/Directed Graphs/Weighted Directed Graphs/concept_strongly_connected_weighted_directed_graph.scs", "scs", 0, 92, 0, 0, 19, 111
"/mnt/dev/development/ostis/study/ostis/gt/Graphs/Directed Graphs/Weighted Directed Graphs/concept_weighted_directed_graph.scs", "scs", 0, 72, 0, 0, 18, 90
"/mnt/dev/development/ostis/study/ostis/gt/Graphs/Directed Graphs/Weighted Directed Graphs/concept_weighted_edge.scs", "scs", 0, 21, 0, 0, 9, 30
"/mnt/dev/development/ostis/study/ostis/gt/Graphs/Directed Graphs/Weighted Directed Graphs/domain_weighted_directed_graphs.scs", "scs", 0, 35, 0, 0, 9, 44
"/mnt/dev/development/ostis/study/ostis/gt/Graphs/Directed Graphs/Weighted Directed Graphs/rib_weight.concept.yaml", "YAML", 27, 0, 0, 0, 3, 30
"/mnt/dev/development/ostis/study/ostis/gt/Graphs/Directed Graphs/Weighted Directed Graphs/strongly_connected_weighted_directed_graph.concept.yaml", "YAML", 73, 0, 0, 0, 5, 78
"/mnt/dev/development/ostis/study/ostis/gt/Graphs/Directed Graphs/Weighted Directed Graphs/weighted_directed_graph.concept.yaml", "YAML", 52, 0, 0, 0, 5, 57
"/mnt/dev/development/ostis/study/ostis/gt/Graphs/Directed Graphs/Weighted Directed Graphs/weighted_directed_graphs.domain.yaml", "YAML", 10, 0, 0, 0, 4, 14
"/mnt/dev/development/ostis/study/ostis/gt/Graphs/Directed Graphs/Weighted Directed Graphs/weighted_edge.concept.yaml", "YAML", 10, 0, 0, 0, 2, 12
"/mnt/dev/development/ostis/study/ostis/gt/Graphs/Directed Graphs/concept_counterfunctional_graph.scs", "scs", 0, 104, 0, 0, 23, 127
"/mnt/dev/development/ostis/study/ostis/gt/Graphs/Directed Graphs/concept_directed_forest.scs", "scs", 0, 42, 0, 0, 11, 53
"/mnt/dev/development/ostis/study/ostis/gt/Graphs/Directed Graphs/concept_directed_tree.scs", "scs", 0, 81, 0, 0, 20, 101
"/mnt/dev/development/ostis/study/ostis/gt/Graphs/Directed Graphs/concept_inverse_graph.scs", "scs", 0, 24, 0, 0, 8, 32
"/mnt/dev/development/ostis/study/ostis/gt/Graphs/Directed Graphs/concept_mixed_graph.scs", "scs", 0, 112, 0, 0, 23, 135
"/mnt/dev/development/ostis/study/ostis/gt/Graphs/Directed Graphs/concept_normalized_graph.scs", "scs", 0, 83, 0, 0, 20, 103
"/mnt/dev/development/ostis/study/ostis/gt/Graphs/Directed Graphs/concept_orientable_graph.scs", "scs", 0, 80, 0, 0, 19, 99
"/mnt/dev/development/ostis/study/ostis/gt/Graphs/Directed Graphs/concept_oriented_eulerian_graphs.scs", "scs", 0, 44, 0, 0, 11, 55
"/mnt/dev/development/ostis/study/ostis/gt/Graphs/Directed Graphs/concept_tournament_graph.scs", "scs", 0, 154, 0, 0, 33, 187
"/mnt/dev/development/ostis/study/ostis/gt/Graphs/Directed Graphs/counterfunctional_graph.concept.yaml", "YAML", 83, 0, 0, 0, 6, 89
"/mnt/dev/development/ostis/study/ostis/gt/Graphs/Directed Graphs/directed_forest.concept.yaml", "YAML", 31, 0, 0, 0, 3, 34
"/mnt/dev/development/ostis/study/ostis/gt/Graphs/Directed Graphs/directed_graphs.domain.yaml", "YAML", 30, 0, 0, 0, 7, 37
"/mnt/dev/development/ostis/study/ostis/gt/Graphs/Directed Graphs/directed_tree.concept.yaml", "YAML", 61, 0, 0, 0, 5, 66
"/mnt/dev/development/ostis/study/ostis/gt/Graphs/Directed Graphs/domain_directed_graphs.scs", "scs", 0, 91, 0, 0, 14, 105
"/mnt/dev/development/ostis/study/ostis/gt/Graphs/Directed Graphs/inverse_graph.concept.yaml", "YAML", 11, 0, 0, 0, 2, 13
"/mnt/dev/development/ostis/study/ostis/gt/Graphs/Directed Graphs/mixed_graph.concept.yaml", "YAML", 85, 0, 0, 0, 6, 91
"/mnt/dev/development/ostis/study/ostis/gt/Graphs/Directed Graphs/normalized_graph.concept.yaml", "YAML", 59, 0, 0, 0, 5, 64
"/mnt/dev/development/ostis/study/ostis/gt/Graphs/Directed Graphs/orientable_graph.concept.yaml", "YAML", 58, 0, 0, 0, 5, 63
"/mnt/dev/development/ostis/study/ostis/gt/Graphs/Directed Graphs/oriented_eulerian_graphs.concept.yaml", "YAML", 30, 0, 0, 0, 3, 33
"/mnt/dev/development/ostis/study/ostis/gt/Graphs/Directed Graphs/tournament_graph.concept.yaml", "YAML", 128, 0, 0, 0, 8, 136
"/mnt/dev/development/ostis/study/ostis/gt/Graphs/Graph Algorithms/Graph Traversal/breadth_traversal.concept.yaml", "YAML", 30, 0, 0, 0, 3, 33
"/mnt/dev/development/ostis/study/ostis/gt/Graphs/Graph Algorithms/Graph Traversal/concept_breadth_traversal.scs", "scs", 0, 44, 0, 0, 12, 56
"/mnt/dev/development/ostis/study/ostis/gt/Graphs/Graph Algorithms/Graph Traversal/concept_depth_traversal.scs", "scs", 0, 60, 0, 0, 15, 75
"/mnt/dev/development/ostis/study/ostis/gt/Graphs/Graph Algorithms/Graph Traversal/concept_graph_traversal.scs", "scs", 0, 72, 0, 0, 17, 89
"/mnt/dev/development/ostis/study/ostis/gt/Graphs/Graph Algorithms/Graph Traversal/concept_in_order_traversal.scs", "scs", 0, 47, 0, 0, 13, 60
"/mnt/dev/development/ostis/study/ostis/gt/Graphs/Graph Algorithms/Graph Traversal/concept_post_order_traversal.scs", "scs", 0, 45, 0, 0, 13, 58
"/mnt/dev/development/ostis/study/ostis/gt/Graphs/Graph Algorithms/Graph Traversal/concept_pre_order_traversal.scs", "scs", 0, 45, 0, 0, 13, 58
"/mnt/dev/development/ostis/study/ostis/gt/Graphs/Graph Algorithms/Graph Traversal/concept_reverse_in_order_traversal.scs", "scs", 0, 47, 0, 0, 13, 60
"/mnt/dev/development/ostis/study/ostis/gt/Graphs/Graph Algorithms/Graph Traversal/concept_reverse_post_order_traversal.scs", "scs", 0, 45, 0, 0, 13, 58
"/mnt/dev/development/ostis/study/ostis/gt/Graphs/Graph Algorithms/Graph Traversal/concept_reverse_pre_order_traversal.scs", "scs", 0, 45, 0, 0, 13, 58
"/mnt/dev/development/ostis/study/ostis/gt/Graphs/Graph Algorithms/Graph Traversal/concept_tree_traversal.scs", "scs", 0, 44, 0, 0, 11, 55
"/mnt/dev/development/ostis/study/ostis/gt/Graphs/Graph Algorithms/Graph Traversal/depth_traversal.concept.yaml", "YAML", 46, 0, 0, 0, 4, 50
"/mnt/dev/development/ostis/study/ostis/gt/Graphs/Graph Algorithms/Graph Traversal/domain_graph_traversal.scs", "scs", 0, 50, 0, 0, 9, 59
"/mnt/dev/development/ostis/study/ostis/gt/Graphs/Graph Algorithms/Graph Traversal/graph_traversal.concept.yaml", "YAML", 57, 0, 0, 0, 5, 62
"/mnt/dev/development/ostis/study/ostis/gt/Graphs/Graph Algorithms/Graph Traversal/graph_traversal.domain.yaml", "YAML", 15, 0, 0, 0, 4, 19
"/mnt/dev/development/ostis/study/ostis/gt/Graphs/Graph Algorithms/Graph Traversal/in_order_traversal.concept.yaml", "YAML", 33, 0, 0, 0, 3, 36
"/mnt/dev/development/ostis/study/ostis/gt/Graphs/Graph Algorithms/Graph Traversal/post_order_traversal.concept.yaml", "YAML", 29, 0, 0, 0, 3, 32
"/mnt/dev/development/ostis/study/ostis/gt/Graphs/Graph Algorithms/Graph Traversal/pre_order_traversal.concept.yaml", "YAML", 28, 0, 0, 0, 3, 31
"/mnt/dev/development/ostis/study/ostis/gt/Graphs/Graph Algorithms/Graph Traversal/reverse_in_order_traversal.concept.yaml", "YAML", 33, 0, 0, 0, 3, 36
"/mnt/dev/development/ostis/study/ostis/gt/Graphs/Graph Algorithms/Graph Traversal/reverse_post_order_traversal.concept.yaml", "YAML", 30, 0, 0, 0, 3, 33
"/mnt/dev/development/ostis/study/ostis/gt/Graphs/Graph Algorithms/Graph Traversal/reverse_pre_order_traversal.concept.yaml", "YAML", 29, 0, 0, 0, 3, 32
"/mnt/dev/development/ostis/study/ostis/gt/Graphs/Graph Algorithms/Graph Traversal/tree_traversal.concept.yaml", "YAML", 28, 0, 0, 0, 4, 32
"/mnt/dev/development/ostis/study/ostis/gt/Graphs/Graph Algorithms/Shortest Paths/concept_dijkstra_algorithm.scs", "scs", 0, 59, 0, 0, 12, 71
"/mnt/dev/development/ostis/study/ostis/gt/Graphs/Graph Algorithms/Shortest Paths/concept_floyd_warshall_algorithm.scs", "scs", 0, 61, 0, 0, 12, 73
"/mnt/dev/development/ostis/study/ostis/gt/Graphs/Graph Algorithms/Shortest Paths/concept_shortest_path_problem.scs", "scs", 0, 55, 0, 0, 13, 68
"/mnt/dev/development/ostis/study/ostis/gt/Graphs/Graph Algorithms/Shortest Paths/dijkstra_algorithm.concept.yaml", "YAML", 49, 0, 0, 0, 3, 52
"/mnt/dev/development/ostis/study/ostis/gt/Graphs/Graph Algorithms/Shortest Paths/domain_shortest_paths.scs", "scs", 0, 34, 0, 0, 11, 45
"/mnt/dev/development/ostis/study/ostis/gt/Graphs/Graph Algorithms/Shortest Paths/floyd_warshall_algorithm.concept.yaml", "YAML", 51, 0, 0, 0, 3, 54
"/mnt/dev/development/ostis/study/ostis/gt/Graphs/Graph Algorithms/Shortest Paths/shortest_path_problem.concept.yaml", "YAML", 46, 0, 0, 0, 4, 50
"/mnt/dev/development/ostis/study/ostis/gt/Graphs/Graph Algorithms/Shortest Paths/shortest_paths.domain.yaml", "YAML", 10, 0, 0, 0, 5, 15
"/mnt/dev/development/ostis/study/ostis/gt/Graphs/Graph Algorithms/concept_graph_algorithm.scs", "scs", 0, 52, 0, 0, 15, 67
"/mnt/dev/development/ostis/study/ostis/gt/Graphs/Graph Algorithms/domain_graph_algorithms.scs", "scs", 0, 41, 0, 0, 13, 54
"/mnt/dev/development/ostis/study/ostis/gt/Graphs/Graph Algorithms/graph_algorithm.concept.yaml", "YAML", 39, 0, 0, 0, 4, 43
"/mnt/dev/development/ostis/study/ostis/gt/Graphs/Graph Algorithms/graph_algorithms.domain.yaml", "YAML", 13, 0, 0, 0, 6, 19
"/mnt/dev/development/ostis/study/ostis/gt/Graphs/Graph Connectivities/block_cutpoint_graph.concept.yaml", "YAML", 38, 0, 0, 0, 3, 41
"/mnt/dev/development/ostis/study/ostis/gt/Graphs/Graph Connectivities/bridge.concept.yaml", "YAML", 34, 0, 0, 0, 3, 37
"/mnt/dev/development/ostis/study/ostis/gt/Graphs/Graph Connectivities/concept_block_cutpoint_graph.scs", "scs", 0, 45, 0, 0, 12, 57
"/mnt/dev/development/ostis/study/ostis/gt/Graphs/Graph Connectivities/concept_bridge.scs", "scs", 0, 43, 0, 0, 12, 55
"/mnt/dev/development/ostis/study/ostis/gt/Graphs/Graph Connectivities/concept_connected_graph.scs", "scs", 0, 86, 0, 0, 19, 105
"/mnt/dev/development/ostis/study/ostis/gt/Graphs/Graph Connectivities/concept_disconnected_graph.scs", "scs", 0, 27, 0, 0, 9, 36
"/mnt/dev/development/ostis/study/ostis/gt/Graphs/Graph Connectivities/concept_non_separable_graph.scs", "scs", 0, 31, 0, 0, 9, 40
"/mnt/dev/development/ostis/study/ostis/gt/Graphs/Graph Connectivities/concept_separable_graph.scs", "scs", 0, 103, 0, 0, 24, 127
"/mnt/dev/development/ostis/study/ostis/gt/Graphs/Graph Connectivities/concept_trivial_graph.scs", "scs", 0, 92, 0, 0, 23, 115
"/mnt/dev/development/ostis/study/ostis/gt/Graphs/Graph Connectivities/connected_graph.concept.yaml", "YAML", 66, 0, 0, 0, 4, 70
"/mnt/dev/development/ostis/study/ostis/gt/Graphs/Graph Connectivities/disconnected_graph.concept.yaml", "YAML", 15, 0, 0, 0, 2, 17
"/mnt/dev/development/ostis/study/ostis/gt/Graphs/Graph Connectivities/domain_graph_connectivity.scs", "scs", 0, 71, 0, 0, 12, 83
"/mnt/dev/development/ostis/study/ostis/gt/Graphs/Graph Connectivities/graph_connectivity.domain.yaml", "YAML", 23, 0, 0, 0, 6, 29
"/mnt/dev/development/ostis/study/ostis/gt/Graphs/Graph Connectivities/non_separable_graph.concept.yaml", "YAML", 19, 0, 0, 0, 2, 21
"/mnt/dev/development/ostis/study/ostis/gt/Graphs/Graph Connectivities/separable_graph.concept.yaml", "YAML", 90, 0, 0, 0, 6, 96
"/mnt/dev/development/ostis/study/ostis/gt/Graphs/Graph Connectivities/trivial_graph.concept.yaml", "YAML", 69, 0, 0, 0, 6, 75
"/mnt/dev/development/ostis/study/ostis/gt/Graphs/Graph Cuts/Graph Cut Space/concept_gomory_hu_tree.scs", "scs", 0, 23, 0, 0, 7, 30
"/mnt/dev/development/ostis/study/ostis/gt/Graphs/Graph Cuts/Graph Cut Space/concept_graph_cut_space.scs", "scs", 0, 25, 0, 0, 7, 32
"/mnt/dev/development/ostis/study/ostis/gt/Graphs/Graph Cuts/Graph Cut Space/concept_orthogonal_complement.scs", "scs", 0, 72, 0, 0, 15, 87
"/mnt/dev/development/ostis/study/ostis/gt/Graphs/Graph Cuts/Graph Cut Space/concept_vector_space.scs", "scs", 0, 30, 0, 0, 8, 38
"/mnt/dev/development/ostis/study/ostis/gt/Graphs/Graph Cuts/Graph Cut Space/domain_graph_cut_space.scs", "scs", 0, 32, 0, 0, 9, 41
"/mnt/dev/development/ostis/study/ostis/gt/Graphs/Graph Cuts/Graph Cut Space/gomory_hu_tree.concept.yaml", "YAML", 14, 0, 0, 0, 2, 16
"/mnt/dev/development/ostis/study/ostis/gt/Graphs/Graph Cuts/Graph Cut Space/graph_cut_space.concept.yaml", "YAML", 19, 0, 0, 0, 2, 21
"/mnt/dev/development/ostis/study/ostis/gt/Graphs/Graph Cuts/Graph Cut Space/graph_cut_space.domain.yaml", "YAML", 9, 0, 0, 0, 4, 13
"/mnt/dev/development/ostis/study/ostis/gt/Graphs/Graph Cuts/Graph Cut Space/orthogonal_complement.concept.yaml", "YAML", 60, 0, 0, 0, 4, 64
"/mnt/dev/development/ostis/study/ostis/gt/Graphs/Graph Cuts/Graph Cut Space/vector_space.concept.yaml", "YAML", 23, 0, 0, 0, 2, 25
"/mnt/dev/development/ostis/study/ostis/gt/Graphs/Graph Cuts/Graph Splits/circle_graph.concept.yaml", "YAML", 77, 0, 0, 0, 5, 82
"/mnt/dev/development/ostis/study/ostis/gt/Graphs/Graph Cuts/Graph Splits/complete_bipartite_graph.concept.yaml", "YAML", 58, 0, 0, 0, 4, 62
"/mnt/dev/development/ostis/study/ostis/gt/Graphs/Graph Cuts/Graph Splits/concept_circle_graph.scs", "scs", 0, 91, 0, 0, 20, 111
"/mnt/dev/development/ostis/study/ostis/gt/Graphs/Graph Cuts/Graph Splits/concept_complete_bipartite_graph.scs", "scs", 0, 70, 0, 0, 15, 85
"/mnt/dev/development/ostis/study/ostis/gt/Graphs/Graph Cuts/Graph Splits/concept_distance_hereditary_graph.scs", "scs", 0, 102, 0, 0, 27, 129
"/mnt/dev/development/ostis/study/ostis/gt/Graphs/Graph Cuts/Graph Splits/concept_graph_split.scs", "scs", 0, 123, 0, 0, 29, 152
"/mnt/dev/development/ostis/study/ostis/gt/Graphs/Graph Cuts/Graph Splits/concept_graph_split_decomposition.scs", "scs", 0, 26, 0, 0, 8, 34
"/mnt/dev/development/ostis/study/ostis/gt/Graphs/Graph Cuts/Graph Splits/distance_hereditary_graph.concept.yaml", "YAML", 85, 0, 0, 0, 7, 92
"/mnt/dev/development/ostis/study/ostis/gt/Graphs/Graph Cuts/Graph Splits/domain_graph_splits.scs", "scs", 0, 40, 0, 0, 11, 51
"/mnt/dev/development/ostis/study/ostis/gt/Graphs/Graph Cuts/Graph Splits/graph_split.concept.yaml", "YAML", 103, 0, 0, 0, 8, 111
"/mnt/dev/development/ostis/study/ostis/gt/Graphs/Graph Cuts/Graph Splits/graph_split_decomposition.concept.yaml", "YAML", 16, 0, 0, 0, 1, 17
"/mnt/dev/development/ostis/study/ostis/gt/Graphs/Graph Cuts/Graph Splits/graph_splits.domain.yaml", "YAML", 12, 0, 0, 0, 5, 17
"/mnt/dev/development/ostis/study/ostis/gt/Graphs/Graph Cuts/Maximum Graph Cuts/bipartite_subgraph.concept.yaml", "YAML", 20, 0, 0, 0, 1, 21
"/mnt/dev/development/ostis/study/ostis/gt/Graphs/Graph Cuts/Maximum Graph Cuts/concept_bipartite_subgraph.scs", "scs", 0, 27, 0, 0, 7, 34
"/mnt/dev/development/ostis/study/ostis/gt/Graphs/Graph Cuts/Maximum Graph Cuts/concept_max_cut_problem.scs", "scs", 0, 120, 0, 0, 23, 143
"/mnt/dev/development/ostis/study/ostis/gt/Graphs/Graph Cuts/Maximum Graph Cuts/concept_maximum_graph_cut.scs", "scs", 0, 44, 0, 0, 11, 55
"/mnt/dev/development/ostis/study/ostis/gt/Graphs/Graph Cuts/Maximum Graph Cuts/concept_weighted_max_cut.scs", "scs", 0, 30, 0, 0, 8, 38
"/mnt/dev/development/ostis/study/ostis/gt/Graphs/Graph Cuts/Maximum Graph Cuts/concept_weighted_max_cut_problem.scs", "scs", 0, 114, 0, 0, 23, 137
"/mnt/dev/development/ostis/study/ostis/gt/Graphs/Graph Cuts/Maximum Graph Cuts/domain_maximum_graph_cuts.scs", "scs", 0, 35, 0, 0, 9, 44
"/mnt/dev/development/ostis/study/ostis/gt/Graphs/Graph Cuts/Maximum Graph Cuts/max_cut_problem.concept.yaml", "YAML", 98, 0, 0, 0, 1, 99
"/mnt/dev/development/ostis/study/ostis/gt/Graphs/Graph Cuts/Maximum Graph Cuts/maximum_graph_cut.concept.yaml", "YAML", 31, 0, 0, 0, 1, 32
"/mnt/dev/development/ostis/study/ostis/gt/Graphs/Graph Cuts/Maximum Graph Cuts/maximum_graph_cuts.domain.yaml", "YAML", 10, 0, 0, 0, 4, 14
"/mnt/dev/development/ostis/study/ostis/gt/Graphs/Graph Cuts/Maximum Graph Cuts/weighted_max_cut.concept.yaml", "YAML", 20, 0, 0, 0, 1, 21
"/mnt/dev/development/ostis/study/ostis/gt/Graphs/Graph Cuts/Maximum Graph Cuts/weighted_max_cut_problem.concept.yaml", "YAML", 93, 0, 0, 0, 1, 94
"/mnt/dev/development/ostis/study/ostis/gt/Graphs/Graph Cuts/Minimum Graph Cuts/concept_graph_sink.scs", "scs", 0, 30, 0, 0, 8, 38
"/mnt/dev/development/ostis/study/ostis/gt/Graphs/Graph Cuts/Minimum Graph Cuts/concept_minimum_graph_cut.scs", "scs", 0, 32, 0, 0, 9, 41
"/mnt/dev/development/ostis/study/ostis/gt/Graphs/Graph Cuts/Minimum Graph Cuts/concept_number_of_minimum_graph_cuts.scs", "scs", 0, 28, 0, 0, 8, 36
"/mnt/dev/development/ostis/study/ostis/gt/Graphs/Graph Cuts/Minimum Graph Cuts/concept_segmentation_based_object_categorization.scs", "scs", 0, 23, 0, 0, 7, 30
"/mnt/dev/development/ostis/study/ostis/gt/Graphs/Graph Cuts/Minimum Graph Cuts/concept_weighted_min_cut_problem.scs", "scs", 0, 31, 0, 0, 9, 40
"/mnt/dev/development/ostis/study/ostis/gt/Graphs/Graph Cuts/Minimum Graph Cuts/domain_minimum_graph_cuts.scs", "scs", 0, 35, 0, 0, 9, 44
"/mnt/dev/development/ostis/study/ostis/gt/Graphs/Graph Cuts/Minimum Graph Cuts/graph_sink.concept.yaml", "YAML", 14, 0, 0, 0, 2, 16
"/mnt/dev/development/ostis/study/ostis/gt/Graphs/Graph Cuts/Minimum Graph Cuts/minimum_graph_cut.concept.yaml", "YAML", 20, 0, 0, 0, 2, 22
"/mnt/dev/development/ostis/study/ostis/gt/Graphs/Graph Cuts/Minimum Graph Cuts/minimum_graph_cuts.domain.yaml", "YAML", 10, 0, 0, 0, 4, 14
"/mnt/dev/development/ostis/study/ostis/gt/Graphs/Graph Cuts/Minimum Graph Cuts/number_of_minimum_graph_cuts.concept.yaml", "YAML", 17, 0, 0, 0, 2, 19
"/mnt/dev/development/ostis/study/ostis/gt/Graphs/Graph Cuts/Minimum Graph Cuts/segmentation_based_object_categorization.concept.yaml", "YAML", 14, 0, 0, 0, 2, 16
"/mnt/dev/development/ostis/study/ostis/gt/Graphs/Graph Cuts/Minimum Graph Cuts/weighted_min_cut_problem.concept.yaml", "YAML", 19, 0, 0, 0, 2, 21
"/mnt/dev/development/ostis/study/ostis/gt/Graphs/Graph Cuts/concept_graph_cut.scs", "scs", 0, 32, 0, 0, 10, 42
"/mnt/dev/development/ostis/study/ostis/gt/Graphs/Graph Cuts/concept_graph_cut_set.scs", "scs", 0, 52, 0, 0, 11, 63
"/mnt/dev/development/ostis/study/ostis/gt/Graphs/Graph Cuts/concept_s_t_cut.scs", "scs", 0, 81, 0, 0, 16, 97
"/mnt/dev/development/ostis/study/ostis/gt/Graphs/Graph Cuts/concept_sparsest_cuts.scs", "scs", 0, 45, 0, 0, 12, 57
"/mnt/dev/development/ostis/study/ostis/gt/Graphs/Graph Cuts/domain_graph_cuts.scs", "scs", 0, 52, 0, 0, 11, 63
"/mnt/dev/development/ostis/study/ostis/gt/Graphs/Graph Cuts/graph_cut.concept.yaml", "YAML", 18, 0, 0, 0, 3, 21
"/mnt/dev/development/ostis/study/ostis/gt/Graphs/Graph Cuts/graph_cut_set.concept.yaml", "YAML", 35, 0, 0, 0, 3, 38
"/mnt/dev/development/ostis/study/ostis/gt/Graphs/Graph Cuts/graph_cuts.domain.yaml", "YAML", 17, 0, 0, 0, 5, 22
"/mnt/dev/development/ostis/study/ostis/gt/Graphs/Graph Cuts/s_t_cut.concept.yaml", "YAML", 53, 0, 0, 0, 4, 57
"/mnt/dev/development/ostis/study/ostis/gt/Graphs/Graph Cuts/sparsest_cuts.concept.yaml", "YAML", 34, 0, 0, 0, 3, 37
"/mnt/dev/development/ostis/study/ostis/gt/Graphs/Graph Operations/Dual Graphs/concept_dual_graph.scs", "scs", 0, 179, 0, 0, 40, 219
"/mnt/dev/development/ostis/study/ostis/gt/Graphs/Graph Operations/Dual Graphs/concept_self_dual_graph.scs", "scs", 0, 21, 0, 0, 7, 28
"/mnt/dev/development/ostis/study/ostis/gt/Graphs/Graph Operations/Dual Graphs/domain_dual_graphs.scs", "scs", 0, 40, 0, 0, 11, 51
"/mnt/dev/development/ostis/study/ostis/gt/Graphs/Graph Operations/Dual Graphs/dual_graph.concept.yaml", "YAML", 162, 0, 0, 0, 10, 172
"/mnt/dev/development/ostis/study/ostis/gt/Graphs/Graph Operations/Dual Graphs/dual_graphs.domain.yaml", "YAML", 12, 0, 0, 0, 5, 17
"/mnt/dev/development/ostis/study/ostis/gt/Graphs/Graph Operations/Dual Graphs/self_dual_graph.concept.yaml", "YAML", 11, 0, 0, 0, 2, 13
"/mnt/dev/development/ostis/study/ostis/gt/Graphs/Graph Operations/domain_graph_operations.scs", "scs", 0, 57, 0, 0, 13, 70
"/mnt/dev/development/ostis/study/ostis/gt/Graphs/Graph Operations/graph_operations.domain.yaml", "YAML", 18, 0, 0, 0, 6, 24
"/mnt/dev/development/ostis/study/ostis/gt/Graphs/Graph Properties/concept_graph_property.scs", "scs", 0, 21, 0, 0, 7, 28
"/mnt/dev/development/ostis/study/ostis/gt/Graphs/Graph Properties/domain_graph_properties.scs", "scs", 0, 53, 0, 0, 12, 65
"/mnt/dev/development/ostis/study/ostis/gt/Graphs/Graph Properties/graph_properties.domain.yaml", "YAML", 17, 0, 0, 0, 6, 23
"/mnt/dev/development/ostis/study/ostis/gt/Graphs/Graph Properties/graph_property.concept.yaml", "YAML", 13, 0, 0, 0, 2, 15
"/mnt/dev/development/ostis/study/ostis/gt/Graphs/Graph Representation/adjacency_list.concept.yaml", "YAML", 51, 0, 0, 0, 4, 55
"/mnt/dev/development/ostis/study/ostis/gt/Graphs/Graph Representation/adjacency_matrix.concept.yaml", "YAML", 39, 0, 0, 0, 3, 42
"/mnt/dev/development/ostis/study/ostis/gt/Graphs/Graph Representation/analytical_method_graph_representation.concept.yaml", "YAML", 13, 0, 0, 0, 2, 15
"/mnt/dev/development/ostis/study/ostis/gt/Graphs/Graph Representation/concept_adjacency_list.scs", "scs", 0, 68, 0, 0, 15, 83
"/mnt/dev/development/ostis/study/ostis/gt/Graphs/Graph Representation/concept_adjacency_matrix.scs", "scs", 0, 48, 0, 0, 11, 59
"/mnt/dev/development/ostis/study/ostis/gt/Graphs/Graph Representation/concept_analytical_method_graph_representation.scs", "scs", 0, 21, 0, 0, 7, 28
"/mnt/dev/development/ostis/study/ostis/gt/Graphs/Graph Representation/concept_graph_representation.scs", "scs", 0, 35, 0, 0, 10, 45
"/mnt/dev/development/ostis/study/ostis/gt/Graphs/Graph Representation/concept_graphical_way_graph_representation.scs", "scs", 0, 21, 0, 0, 7, 28
"/mnt/dev/development/ostis/study/ostis/gt/Graphs/Graph Representation/concept_incidence_list.scs", "scs", 0, 76, 0, 0, 19, 95
"/mnt/dev/development/ostis/study/ostis/gt/Graphs/Graph Representation/concept_incidence_matrix.scs", "scs", 0, 68, 0, 0, 15, 83
"/mnt/dev/development/ostis/study/ostis/gt/Graphs/Graph Representation/domain_graph_representation.scs", "scs", 0, 41, 0, 0, 9, 50
"/mnt/dev/development/ostis/study/ostis/gt/Graphs/Graph Representation/graph_representation.concept.yaml", "YAML", 20, 0, 0, 0, 3, 23
"/mnt/dev/development/ostis/study/ostis/gt/Graphs/Graph Representation/graph_representation.domain.yaml", "YAML", 12, 0, 0, 0, 4, 16
"/mnt/dev/development/ostis/study/ostis/gt/Graphs/Graph Representation/graphical_way_graph_representation.concept.yaml", "YAML", 13, 0, 0, 0, 2, 15
"/mnt/dev/development/ostis/study/ostis/gt/Graphs/Graph Representation/incidence_list.concept.yaml", "YAML", 61, 0, 0, 0, 5, 66
"/mnt/dev/development/ostis/study/ostis/gt/Graphs/Graph Representation/incidence_matrix.concept.yaml", "YAML", 56, 0, 0, 0, 4, 60
"/mnt/dev/development/ostis/study/ostis/gt/Graphs/Graph Sequences/Graph Chains/alternating_chain.concept.yaml", "YAML", 28, 0, 0, 0, 3, 31
"/mnt/dev/development/ostis/study/ostis/gt/Graphs/Graph Sequences/Graph Chains/chain_length.concept.yaml", "YAML", 30, 0, 0, 0, 3, 33
"/mnt/dev/development/ostis/study/ostis/gt/Graphs/Graph Sequences/Graph Chains/chain_weight.concept.yaml", "YAML", 74, 0, 0, 0, 6, 80
"/mnt/dev/development/ostis/study/ostis/gt/Graphs/Graph Sequences/Graph Chains/concept_alternating_chain.scs", "scs", 0, 44, 0, 0, 11, 55
"/mnt/dev/development/ostis/study/ostis/gt/Graphs/Graph Sequences/Graph Chains/concept_chain_length.scs", "scs", 0, 46, 0, 0, 11, 57
"/mnt/dev/development/ostis/study/ostis/gt/Graphs/Graph Sequences/Graph Chains/concept_chain_weight.scs", "scs", 0, 99, 0, 0, 24, 123
"/mnt/dev/development/ostis/study/ostis/gt/Graphs/Graph Sequences/Graph Chains/concept_eulerian_chain.scs", "scs", 0, 46, 0, 0, 11, 57
"/mnt/dev/development/ostis/study/ostis/gt/Graphs/Graph Sequences/Graph Chains/concept_graph_chain.scs", "scs", 0, 59, 0, 0, 14, 73
"/mnt/dev/development/ostis/study/ostis/gt/Graphs/Graph Sequences/Graph Chains/concept_graph_subchain.scs", "scs", 0, 110, 0, 0, 23, 133
"/mnt/dev/development/ostis/study/ostis/gt/Graphs/Graph Sequences/Graph Chains/concept_hamiltonian_chain.scs", "scs", 0, 54, 0, 0, 11, 65
"/mnt/dev/development/ostis/study/ostis/gt/Graphs/Graph Sequences/Graph Chains/concept_simple_graph_chain.scs", "scs", 0, 46, 0, 0, 11, 57
"/mnt/dev/development/ostis/study/ostis/gt/Graphs/Graph Sequences/Graph Chains/domain_graph_chains.scs", "scs", 0, 49, 0, 0, 11, 60
"/mnt/dev/development/ostis/study/ostis/gt/Graphs/Graph Sequences/Graph Chains/eulerian_chain.concept.yaml", "YAML", 30, 0, 0, 0, 3, 33
"/mnt/dev/development/ostis/study/ostis/gt/Graphs/Graph Sequences/Graph Chains/graph_chain.concept.yaml", "YAML", 43, 0, 0, 0, 4, 47
"/mnt/dev/development/ostis/study/ostis/gt/Graphs/Graph Sequences/Graph Chains/graph_chains.domain.yaml", "YAML", 15, 0, 0, 0, 5, 20
"/mnt/dev/development/ostis/study/ostis/gt/Graphs/Graph Sequences/Graph Chains/graph_subchain.concept.yaml", "YAML", 87, 0, 0, 0, 6, 93
"/mnt/dev/development/ostis/study/ostis/gt/Graphs/Graph Sequences/Graph Chains/hamiltonian_chain.concept.yaml", "YAML", 41, 0, 0, 0, 3, 44
"/mnt/dev/development/ostis/study/ostis/gt/Graphs/Graph Sequences/Graph Chains/simple_graph_chain.concept.yaml", "YAML", 32, 0, 0, 0, 3, 35
"/mnt/dev/development/ostis/study/ostis/gt/Graphs/Graph Sequences/Graph Cycles/basic_cycle.concept.yaml", "YAML", 31, 0, 0, 0, 3, 34
"/mnt/dev/development/ostis/study/ostis/gt/Graphs/Graph Sequences/Graph Cycles/concept_basic_cycle.scs", "scs", 0, 48, 0, 0, 11, 59
"/mnt/dev/development/ostis/study/ostis/gt/Graphs/Graph Sequences/Graph Cycles/concept_cycle_length.scs", "scs", 0, 74, 0, 0, 19, 93
"/mnt/dev/development/ostis/study/ostis/gt/Graphs/Graph Sequences/Graph Cycles/concept_cycle_weight.scs", "scs", 0, 65, 0, 0, 16, 81
"/mnt/dev/development/ostis/study/ostis/gt/Graphs/Graph Sequences/Graph Cycles/concept_cyclic_graph.scs", "scs", 0, 41, 0, 0, 10, 51
"/mnt/dev/development/ostis/study/ostis/gt/Graphs/Graph Sequences/Graph Cycles/concept_eulerian_cycle.scs", "scs", 0, 46, 0, 0, 11, 57
"/mnt/dev/development/ostis/study/ostis/gt/Graphs/Graph Sequences/Graph Cycles/concept_graph_cycle.scs", "scs", 0, 61, 0, 0, 13, 74
"/mnt/dev/development/ostis/study/ostis/gt/Graphs/Graph Sequences/Graph Cycles/concept_graph_girth.scs", "scs", 0, 38, 0, 0, 11, 49
"/mnt/dev/development/ostis/study/ostis/gt/Graphs/Graph Sequences/Graph Cycles/concept_hamiltonian_cycle.scs", "scs", 0, 49, 0, 0, 12, 61
"/mnt/dev/development/ostis/study/ostis/gt/Graphs/Graph Sequences/Graph Cycles/concept_minimum_weight_cycle.scs", "scs", 0, 59, 0, 0, 12, 71
"/mnt/dev/development/ostis/study/ostis/gt/Graphs/Graph Sequences/Graph Cycles/cycle_length.concept.yaml", "YAML", 51, 0, 0, 0, 5, 56
"/mnt/dev/development/ostis/study/ostis/gt/Graphs/Graph Sequences/Graph Cycles/cycle_weight.concept.yaml", "YAML", 48, 0, 0, 0, 4, 52
"/mnt/dev/development/ostis/study/ostis/gt/Graphs/Graph Sequences/Graph Cycles/cyclic_graph.concept.yaml", "YAML", 28, 0, 0, 0, 3, 31
"/mnt/dev/development/ostis/study/ostis/gt/Graphs/Graph Sequences/Graph Cycles/domain_graph_cycles.scs", "scs", 0, 55, 0, 0, 11, 66
"/mnt/dev/development/ostis/study/ostis/gt/Graphs/Graph Sequences/Graph Cycles/eulerian_cycle.concept.yaml", "YAML", 30, 0, 0, 0, 3, 33
"/mnt/dev/development/ostis/study/ostis/gt/Graphs/Graph Sequences/Graph Cycles/graph_cycle.concept.yaml", "YAML", 42, 0, 0, 0, 4, 46
"/mnt/dev/development/ostis/study/ostis/gt/Graphs/Graph Sequences/Graph Cycles/graph_cycles.domain.yaml", "YAML", 17, 0, 0, 0, 5, 22
"/mnt/dev/development/ostis/study/ostis/gt/Graphs/Graph Sequences/Graph Cycles/graph_girth.concept.yaml", "YAML", 21, 0, 0, 0, 3, 24
"/mnt/dev/development/ostis/study/ostis/gt/Graphs/Graph Sequences/Graph Cycles/hamiltonian_cycle.concept.yaml", "YAML", 36, 0, 0, 0, 3, 39
"/mnt/dev/development/ostis/study/ostis/gt/Graphs/Graph Sequences/Graph Cycles/minimum_weight_cycle.concept.yaml", "YAML", 39, 0, 0, 0, 3, 42
"/mnt/dev/development/ostis/study/ostis/gt/Graphs/Graph Sequences/Graph Paths/concept_eulerian_path.scs", "scs", 0, 65, 0, 0, 16, 81
"/mnt/dev/development/ostis/study/ostis/gt/Graphs/Graph Sequences/Graph Paths/concept_graph_diameter.scs", "scs", 0, 53, 0, 0, 12, 65
"/mnt/dev/development/ostis/study/ostis/gt/Graphs/Graph Sequences/Graph Paths/concept_graph_eccentricity.scs", "scs", 0, 77, 0, 0, 20, 97
"/mnt/dev/development/ostis/study/ostis/gt/Graphs/Graph Sequences/Graph Paths/concept_graph_path.scs", "scs", 0, 139, 0, 0, 34, 173
"/mnt/dev/development/ostis/study/ostis/gt/Graphs/Graph Sequences/Graph Paths/concept_graph_path_weight.scs", "scs", 0, 50, 0, 0, 13, 63
"/mnt/dev/development/ostis/study/ostis/gt/Graphs/Graph Sequences/Graph Paths/concept_graph_radius.scs", "scs", 0, 49, 0, 0, 12, 61
"/mnt/dev/development/ostis/study/ostis/gt/Graphs/Graph Sequences/Graph Paths/concept_hamiltonian_path.scs", "scs", 0, 71, 0, 0, 16, 87
"/mnt/dev/development/ostis/study/ostis/gt/Graphs/Graph Sequences/Graph Paths/concept_longest_path.scs", "scs", 0, 37, 0, 0, 10, 47
"/mnt/dev/development/ostis/study/ostis/gt/Graphs/Graph Sequences/Graph Paths/concept_path_length.scs", "scs", 0, 63, 0, 0, 16, 79
"/mnt/dev/development/ostis/study/ostis/gt/Graphs/Graph Sequences/Graph Paths/concept_shortest_path.scs", "scs", 0, 59, 0, 0, 16, 75
"/mnt/dev/development/ostis/study/ostis/gt/Graphs/Graph Sequences/Graph Paths/domain_graph_paths.scs", "scs", 0, 68, 0, 0, 12, 80
"/mnt/dev/development/ostis/study/ostis/gt/Graphs/Graph Sequences/Graph Paths/eulerian_path.concept.yaml", "YAML", 43, 0, 0, 0, 4, 47
"/mnt/dev/development/ostis/study/ostis/gt/Graphs/Graph Sequences/Graph Paths/graph_diameter.concept.yaml", "YAML", 30, 0, 0, 0, 3, 33
"/mnt/dev/development/ostis/study/ostis/gt/Graphs/Graph Sequences/Graph Paths/graph_eccentricity.concept.yaml", "YAML", 55, 0, 0, 0, 5, 60
"/mnt/dev/development/ostis/study/ostis/gt/Graphs/Graph Sequences/Graph Paths/graph_path.concept.yaml", "YAML", 101, 0, 0, 0, 9, 110
"/mnt/dev/development/ostis/study/ostis/gt/Graphs/Graph Sequences/Graph Paths/graph_path_weight.concept.yaml", "YAML", 29, 0, 0, 0, 3, 32
"/mnt/dev/development/ostis/study/ostis/gt/Graphs/Graph Sequences/Graph Paths/graph_paths.domain.yaml", "YAML", 22, 0, 0, 0, 7, 29
"/mnt/dev/development/ostis/study/ostis/gt/Graphs/Graph Sequences/Graph Paths/graph_radius.concept.yaml", "YAML", 28, 0, 0, 0, 3, 31
"/mnt/dev/development/ostis/study/ostis/gt/Graphs/Graph Sequences/Graph Paths/hamiltonian_path.concept.yaml", "YAML", 51, 0, 0, 0, 4, 55
"/mnt/dev/development/ostis/study/ostis/gt/Graphs/Graph Sequences/Graph Paths/longest_path.concept.yaml", "YAML", 24, 0, 0, 0, 3, 27
"/mnt/dev/development/ostis/study/ostis/gt/Graphs/Graph Sequences/Graph Paths/path_length.concept.yaml", "YAML", 50, 0, 0, 0, 4, 54
"/mnt/dev/development/ostis/study/ostis/gt/Graphs/Graph Sequences/Graph Paths/shortest_path.concept.yaml", "YAML", 38, 0, 0, 0, 4, 42
"/mnt/dev/development/ostis/study/ostis/gt/Graphs/Graph Sequences/concept_directed_sequence.scs", "scs", 0, 55, 0, 0, 12, 67
"/mnt/dev/development/ostis/study/ostis/gt/Graphs/Graph Sequences/concept_graph_sequence.scs", "scs", 0, 75, 0, 0, 18, 93
"/mnt/dev/development/ostis/study/ostis/gt/Graphs/Graph Sequences/concept_length_of_sequence.scs", "scs", 0, 101, 0, 0, 24, 125
"/mnt/dev/development/ostis/study/ostis/gt/Graphs/Graph Sequences/concept_spanning_sequence.scs", "scs", 0, 57, 0, 0, 16, 73
"/mnt/dev/development/ostis/study/ostis/gt/Graphs/Graph Sequences/concept_tightened_graph.scs", "scs", 0, 53, 0, 0, 12, 65
"/mnt/dev/development/ostis/study/ostis/gt/Graphs/Graph Sequences/directed_sequence.concept.yaml", "YAML", 37, 0, 0, 0, 3, 40
"/mnt/dev/development/ostis/study/ostis/gt/Graphs/Graph Sequences/domain_graph_sequences.scs", "scs", 0, 55, 0, 0, 13, 68
"/mnt/dev/development/ostis/study/ostis/gt/Graphs/Graph Sequences/graph_sequence.concept.yaml", "YAML", 59, 0, 0, 0, 5, 64
"/mnt/dev/development/ostis/study/ostis/gt/Graphs/Graph Sequences/graph_sequences.domain.yaml", "YAML", 18, 0, 0, 0, 6, 24
"/mnt/dev/development/ostis/study/ostis/gt/Graphs/Graph Sequences/length_of_sequence.concept.yaml", "YAML", 67, 0, 0, 0, 6, 73
"/mnt/dev/development/ostis/study/ostis/gt/Graphs/Graph Sequences/spanning_sequence.concept.yaml", "YAML", 31, 0, 0, 0, 4, 35
"/mnt/dev/development/ostis/study/ostis/gt/Graphs/Graph Sequences/tightened_graph.concept.yaml", "YAML", 40, 0, 0, 0, 3, 43
"/mnt/dev/development/ostis/study/ostis/gt/Graphs/Multigraphs/Hypergraphs/concept_directed_hypergraph.scs", "scs", 0, 40, 0, 0, 11, 51
"/mnt/dev/development/ostis/study/ostis/gt/Graphs/Multigraphs/Hypergraphs/concept_hypergraph.scs", "scs", 0, 55, 0, 0, 13, 68
"/mnt/dev/development/ostis/study/ostis/gt/Graphs/Multigraphs/Hypergraphs/concept_hypergraph_edge.scs", "scs", 0, 53, 0, 0, 12, 65
"/mnt/dev/development/ostis/study/ostis/gt/Graphs/Multigraphs/Hypergraphs/concept_undirected_hypergraph.scs", "scs", 0, 40, 0, 0, 11, 51
"/mnt/dev/development/ostis/study/ostis/gt/Graphs/Multigraphs/Hypergraphs/directed_hypergraph.concept.yaml", "YAML", 26, 0, 0, 0, 3, 29
"/mnt/dev/development/ostis/study/ostis/gt/Graphs/Multigraphs/Hypergraphs/domain_hypergraphs.scs", "scs", 0, 41, 0, 0, 12, 53
"/mnt/dev/development/ostis/study/ostis/gt/Graphs/Multigraphs/Hypergraphs/hypergraph.concept.yaml", "YAML", 36, 0, 0, 0, 4, 40
"/mnt/dev/development/ostis/study/ostis/gt/Graphs/Multigraphs/Hypergraphs/hypergraph_edge.concept.yaml", "YAML", 34, 0, 0, 0, 3, 37
"/mnt/dev/development/ostis/study/ostis/gt/Graphs/Multigraphs/Hypergraphs/hypergraphs.domain.yaml", "YAML", 13, 0, 0, 0, 6, 19
"/mnt/dev/development/ostis/study/ostis/gt/Graphs/Multigraphs/Hypergraphs/undirected_hypergraph.concept.yaml", "YAML", 27, 0, 0, 0, 3, 30
"/mnt/dev/development/ostis/study/ostis/gt/Graphs/Multigraphs/concept_directed_multigraph.scs", "scs", 0, 40, 0, 0, 11, 51
"/mnt/dev/development/ostis/study/ostis/gt/Graphs/Multigraphs/concept_multigraph.scs", "scs", 0, 65, 0, 0, 13, 78
"/mnt/dev/development/ostis/study/ostis/gt/Graphs/Multigraphs/concept_multiple_arcs.scs", "scs", 0, 42, 0, 0, 11, 53
"/mnt/dev/development/ostis/study/ostis/gt/Graphs/Multigraphs/concept_multiple_edges.scs", "scs", 0, 55, 0, 0, 12, 67
"/mnt/dev/development/ostis/study/ostis/gt/Graphs/Multigraphs/concept_undirected_multigraph.scs", "scs", 0, 40, 0, 0, 11, 51
"/mnt/dev/development/ostis/study/ostis/gt/Graphs/Multigraphs/directed_multigraph.concept.yaml", "YAML", 30, 0, 0, 0, 3, 33
"/mnt/dev/development/ostis/study/ostis/gt/Graphs/Multigraphs/domain_multigraphs.scs", "scs", 0, 48, 0, 0, 13, 61
"/mnt/dev/development/ostis/study/ostis/gt/Graphs/Multigraphs/multigraph.concept.yaml", "YAML", 46, 0, 0, 0, 4, 50
"/mnt/dev/development/ostis/study/ostis/gt/Graphs/Multigraphs/multigraphs.domain.yaml", "YAML", 15, 0, 0, 0, 6, 21
"/mnt/dev/development/ostis/study/ostis/gt/Graphs/Multigraphs/multiple_arcs.concept.yaml", "YAML", 29, 0, 0, 0, 3, 32
"/mnt/dev/development/ostis/study/ostis/gt/Graphs/Multigraphs/multiple_edges.concept.yaml", "YAML", 40, 0, 0, 0, 3, 43
"/mnt/dev/development/ostis/study/ostis/gt/Graphs/Multigraphs/undirected_multigraph.concept.yaml", "YAML", 30, 0, 0, 0, 3, 33
"/mnt/dev/development/ostis/study/ostis/gt/Graphs/Planar Graphs/Graph Coloring/chromatic_index.concept.yaml", "YAML", 95, 0, 0, 0, 9, 104
"/mnt/dev/development/ostis/study/ostis/gt/Graphs/Planar Graphs/Graph Coloring/chromatic_number.concept.yaml", "YAML", 35, 0, 0, 0, 4, 39
"/mnt/dev/development/ostis/study/ostis/gt/Graphs/Planar Graphs/Graph Coloring/chromatic_polynomial.concept.yaml", "YAML", 41, 0, 0, 0, 4, 45
"/mnt/dev/development/ostis/study/ostis/gt/Graphs/Planar Graphs/Graph Coloring/color_class.concept.yaml", "YAML", 42, 0, 0, 0, 3, 45
"/mnt/dev/development/ostis/study/ostis/gt/Graphs/Planar Graphs/Graph Coloring/coloring_areas.concept.yaml", "YAML", 36, 0, 0, 0, 4, 40
"/mnt/dev/development/ostis/study/ostis/gt/Graphs/Planar Graphs/Graph Coloring/concept_chromatic_index.scs", "scs", 0, 137, 0, 0, 34, 171
"/mnt/dev/development/ostis/study/ostis/gt/Graphs/Planar Graphs/Graph Coloring/concept_chromatic_number.scs", "scs", 0, 53, 0, 0, 14, 67
"/mnt/dev/development/ostis/study/ostis/gt/Graphs/Planar Graphs/Graph Coloring/concept_chromatic_polynomial.scs", "scs", 0, 54, 0, 0, 15, 69
"/mnt/dev/development/ostis/study/ostis/gt/Graphs/Planar Graphs/Graph Coloring/concept_color_class.scs", "scs", 0, 72, 0, 0, 15, 87
"/mnt/dev/development/ostis/study/ostis/gt/Graphs/Planar Graphs/Graph Coloring/concept_coloring_areas.scs", "scs", 0, 60, 0, 0, 15, 75
"/mnt/dev/development/ostis/study/ostis/gt/Graphs/Planar Graphs/Graph Coloring/concept_edge_coloring.scs", "scs", 0, 64, 0, 0, 18, 82
"/mnt/dev/development/ostis/study/ostis/gt/Graphs/Planar Graphs/Graph Coloring/concept_graph_coloring.scs", "scs", 0, 64, 0, 0, 17, 81
"/mnt/dev/development/ostis/study/ostis/gt/Graphs/Planar Graphs/Graph Coloring/concept_total_coloring.scs", "scs", 0, 64, 0, 0, 15, 79
"/mnt/dev/development/ostis/study/ostis/gt/Graphs/Planar Graphs/Graph Coloring/concept_vertex_coloring.scs", "scs", 0, 52, 0, 0, 14, 66
"/mnt/dev/development/ostis/study/ostis/gt/Graphs/Planar Graphs/Graph Coloring/domain_graphs_coloring.scs", "scs", 0, 55, 0, 0, 11, 66
"/mnt/dev/development/ostis/study/ostis/gt/Graphs/Planar Graphs/Graph Coloring/edge_coloring.concept.yaml", "YAML", 48, 0, 0, 0, 5, 53
"/mnt/dev/development/ostis/study/ostis/gt/Graphs/Planar Graphs/Graph Coloring/graph_coloring.concept.yaml", "YAML", 46, 0, 0, 0, 5, 51
"/mnt/dev/development/ostis/study/ostis/gt/Graphs/Planar Graphs/Graph Coloring/graphs_coloring.domain.yaml", "YAML", 17, 0, 0, 0, 5, 22
"/mnt/dev/development/ostis/study/ostis/gt/Graphs/Planar Graphs/Graph Coloring/total_coloring.concept.yaml", "YAML", 49, 0, 0, 0, 4, 53
"/mnt/dev/development/ostis/study/ostis/gt/Graphs/Planar Graphs/Graph Coloring/vertex_coloring.concept.yaml", "YAML", 39, 0, 0, 0, 4, 43
"/mnt/dev/development/ostis/study/ostis/gt/Graphs/Planar Graphs/Graph Embeddings/concept_eulers_genus.scs", "scs", 0, 49, 0, 0, 12, 61
"/mnt/dev/development/ostis/study/ostis/gt/Graphs/Planar Graphs/Graph Embeddings/concept_genus.scs", "scs", 0, 72, 0, 0, 19, 91
"/mnt/dev/development/ostis/study/ostis/gt/Graphs/Planar Graphs/Graph Embeddings/concept_graph_embedding.scs", "scs", 0, 103, 0, 0, 26, 129
"/mnt/dev/development/ostis/study/ostis/gt/Graphs/Planar Graphs/Graph Embeddings/concept_maximum_genus.scs", "scs", 0, 21, 0, 0, 7, 28
"/mnt/dev/development/ostis/study/ostis/gt/Graphs/Planar Graphs/Graph Embeddings/domain_graphs_embeddings.scs", "scs", 0, 32, 0, 0, 9, 41
"/mnt/dev/development/ostis/study/ostis/gt/Graphs/Planar Graphs/Graph Embeddings/eulers_genus.concept.yaml", "YAML", 31, 0, 0, 0, 3, 34
"/mnt/dev/development/ostis/study/ostis/gt/Graphs/Planar Graphs/Graph Embeddings/genus.concept.yaml", "YAML", 58, 0, 0, 0, 5, 63
"/mnt/dev/development/ostis/study/ostis/gt/Graphs/Planar Graphs/Graph Embeddings/graph_embedding.concept.yaml", "YAML", 84, 0, 0, 0, 7, 91
"/mnt/dev/development/ostis/study/ostis/gt/Graphs/Planar Graphs/Graph Embeddings/graphs_embeddings.domain.yaml", "YAML", 9, 0, 0, 0, 3, 12
"/mnt/dev/development/ostis/study/ostis/gt/Graphs/Planar Graphs/Graph Embeddings/maximum_genus.concept.yaml", "YAML", 9, 0, 0, 0, 2, 11
"/mnt/dev/development/ostis/study/ostis/gt/Graphs/Planar Graphs/concept_external_graph.scs", "scs", 0, 21, 0, 0, 7, 28
"/mnt/dev/development/ostis/study/ostis/gt/Graphs/Planar Graphs/concept_external_planar_graph.scs", "scs", 0, 71, 0, 0, 17, 88
"/mnt/dev/development/ostis/study/ostis/gt/Graphs/Planar Graphs/concept_graph_diamond.scs", "scs", 0, 108, 0, 0, 27, 135
"/mnt/dev/development/ostis/study/ostis/gt/Graphs/Planar Graphs/concept_graph_halina.scs", "scs", 0, 92, 0, 0, 19, 111
"/mnt/dev/development/ostis/study/ostis/gt/Graphs/Planar Graphs/concept_medial_graph.scs", "scs", 0, 99, 0, 0, 24, 123
"/mnt/dev/development/ostis/study/ostis/gt/Graphs/Planar Graphs/concept_one_planar_graph.scs", "scs", 0, 79, 0, 0, 20, 99
"/mnt/dev/development/ostis/study/ostis/gt/Graphs/Planar Graphs/concept_planar_graph.scs", "scs", 0, 92, 0, 0, 22, 114
"/mnt/dev/development/ostis/study/ostis/gt/Graphs/Planar Graphs/concept_triangle_graph.scs", "scs", 0, 107, 0, 0, 25, 132
"/mnt/dev/development/ostis/study/ostis/gt/Graphs/Planar Graphs/concept_unplanar_graph.scs", "scs", 0, 119, 0, 0, 28, 147
"/mnt/dev/development/ostis/study/ostis/gt/Graphs/Planar Graphs/domain_planar_graphs.scs", "scs", 0, 77, 0, 0, 13, 90
"/mnt/dev/development/ostis/study/ostis/gt/Graphs/Planar Graphs/external_graph.concept.yaml", "YAML", 9, 0, 0, 0, 2, 11
"/mnt/dev/development/ostis/study/ostis/gt/Graphs/Planar Graphs/external_planar_graph.concept.yaml", "YAML", 48, 0, 0, 0, 4, 52
"/mnt/dev/development/ostis/study/ostis/gt/Graphs/Planar Graphs/graph_diamond.concept.yaml", "YAML", 68, 0, 0, 0, 7, 75
"/mnt/dev/development/ostis/study/ostis/gt/Graphs/Planar Graphs/graph_halina.concept.yaml", "YAML", 73, 0, 0, 0, 5, 78
"/mnt/dev/development/ostis/study/ostis/gt/Graphs/Planar Graphs/medial_graph.concept.yaml", "YAML", 71, 0, 0, 0, 6, 77
"/mnt/dev/development/ostis/study/ostis/gt/Graphs/Planar Graphs/one_planar_graph.concept.yaml", "YAML", 51, 0, 0, 0, 5, 56
"/mnt/dev/development/ostis/study/ostis/gt/Graphs/Planar Graphs/planar_graph.concept.yaml", "YAML", 65, 0, 0, 0, 6, 71
"/mnt/dev/development/ostis/study/ostis/gt/Graphs/Planar Graphs/planar_graphs.domain.yaml", "YAML", 25, 0, 0, 0, 6, 31
"/mnt/dev/development/ostis/study/ostis/gt/Graphs/Planar Graphs/triangle_graph.concept.yaml", "YAML", 71, 0, 0, 0, 6, 77
"/mnt/dev/development/ostis/study/ostis/gt/Graphs/Planar Graphs/unplanar_graph.concept.yaml", "YAML", 87, 0, 0, 0, 7, 94
"/mnt/dev/development/ostis/study/ostis/gt/Graphs/Subgraphs/bicoloured_subgraph.concept.yaml", "YAML", 47, 0, 0, 0, 4, 51
"/mnt/dev/development/ostis/study/ostis/gt/Graphs/Subgraphs/complete_subgraph.concept.yaml", "YAML", 29, 0, 0, 0, 3, 32
"/mnt/dev/development/ostis/study/ostis/gt/Graphs/Subgraphs/concept_bicoloured_subgraph.scs", "scs", 0, 71, 0, 0, 16, 87
"/mnt/dev/development/ostis/study/ostis/gt/Graphs/Subgraphs/concept_complete_subgraph.scs", "scs", 0, 51, 0, 0, 12, 63
"/mnt/dev/development/ostis/study/ostis/gt/Graphs/Subgraphs/concept_induced_subgraph.scs", "scs", 0, 77, 0, 0, 17, 94
"/mnt/dev/development/ostis/study/ostis/gt/Graphs/Subgraphs/concept_isometric_subgraph.scs", "scs", 0, 47, 0, 0, 12, 59
"/mnt/dev/development/ostis/study/ostis/gt/Graphs/Subgraphs/concept_subgraph.scs", "scs", 0, 119, 0, 0, 26, 145
"/mnt/dev/development/ostis/study/ostis/gt/Graphs/Subgraphs/concept_tightened_subgraph.scs", "scs", 0, 51, 0, 0, 12, 63
"/mnt/dev/development/ostis/study/ostis/gt/Graphs/Subgraphs/domain_subgraphs.scs", "scs", 0, 55, 0, 0, 11, 66
"/mnt/dev/development/ostis/study/ostis/gt/Graphs/Subgraphs/induced_subgraph.concept.yaml", "YAML", 56, 0, 0, 0, 4, 60
"/mnt/dev/development/ostis/study/ostis/gt/Graphs/Subgraphs/isometric_subgraph.concept.yaml", "YAML", 29, 0, 0, 0, 3, 32
"/mnt/dev/development/ostis/study/ostis/gt/Graphs/Subgraphs/subgraph.concept.yaml", "YAML", 84, 0, 0, 0, 7, 91
"/mnt/dev/development/ostis/study/ostis/gt/Graphs/Subgraphs/subgraphs.domain.yaml", "YAML", 17, 0, 0, 0, 5, 22
"/mnt/dev/development/ostis/study/ostis/gt/Graphs/Subgraphs/tightened_subgraph.concept.yaml", "YAML", 33, 0, 0, 0, 3, 36
"/mnt/dev/development/ostis/study/ostis/gt/Graphs/arc.concept.yaml", "YAML", 20, 0, 0, 0, 1, 21
"/mnt/dev/development/ostis/study/ostis/gt/Graphs/bipartite_graph.concept.yaml", "YAML", 85, 0, 0, 0, 1, 86
"/mnt/dev/development/ostis/study/ostis/gt/Graphs/complete_graph.concept.yaml", "YAML", 27, 0, 0, 0, 1, 28
"/mnt/dev/development/ostis/study/ostis/gt/Graphs/concept_arc.scs", "scs", 0, 31, 0, 0, 9, 40
"/mnt/dev/development/ostis/study/ostis/gt/Graphs/concept_bipartite_graph.scs", "scs", 0, 94, 0, 0, 19, 113
"/mnt/dev/development/ostis/study/ostis/gt/Graphs/concept_complete_graph.scs", "scs", 0, 46, 0, 0, 11, 57
"/mnt/dev/development/ostis/study/ostis/gt/Graphs/concept_directed_graph.scs", "scs", 0, 142, 0, 0, 31, 173
"/mnt/dev/development/ostis/study/ostis/gt/Graphs/concept_edge.scs", "scs", 0, 50, 0, 0, 11, 61
"/mnt/dev/development/ostis/study/ostis/gt/Graphs/concept_graph.scs", "scs", 0, 116, 0, 0, 21, 137
"/mnt/dev/development/ostis/study/ostis/gt/Graphs/concept_graph_structure.scs", "scs", 0, 102, 0, 0, 23, 125
"/mnt/dev/development/ostis/study/ostis/gt/Graphs/concept_network.scs", "scs", 0, 64, 0, 0, 15, 79
"/mnt/dev/development/ostis/study/ostis/gt/Graphs/concept_null_graph.scs", "scs", 0, 54, 0, 0, 12, 66
"/mnt/dev/development/ostis/study/ostis/gt/Graphs/concept_pseudograph.scs", "scs", 0, 86, 0, 0, 19, 105
"/mnt/dev/development/ostis/study/ostis/gt/Graphs/concept_regular_graph.scs", "scs", 0, 91, 0, 0, 21, 112
"/mnt/dev/development/ostis/study/ostis/gt/Graphs/concept_simple_graph.scs", "scs", 0, 52, 0, 0, 11, 63
"/mnt/dev/development/ostis/study/ostis/gt/Graphs/concept_supergraph.scs", "scs", 0, 97, 0, 0, 22, 119
"/mnt/dev/development/ostis/study/ostis/gt/Graphs/concept_undirected_graph.scs", "scs", 0, 78, 0, 0, 15, 93
"/mnt/dev/development/ostis/study/ostis/gt/Graphs/concept_unweighted_graph.scs", "scs", 0, 124, 0, 0, 32, 156
"/mnt/dev/development/ostis/study/ostis/gt/Graphs/concept_vertex.scs", "scs", 0, 97, 0, 0, 24, 121
"/mnt/dev/development/ostis/study/ostis/gt/Graphs/concept_weighted_graph.scs", "scs", 0, 78, 0, 0, 19, 97
"/mnt/dev/development/ostis/study/ostis/gt/Graphs/directed_graph.concept.yaml", "YAML", 104, 0, 0, 0, 2, 106
"/mnt/dev/development/ostis/study/ostis/gt/Graphs/domain_graphs.scs", "scs", 0, 159, 0, 0, 14, 173
"/mnt/dev/development/ostis/study/ostis/gt/Graphs/edge.concept.yaml", "YAML", 32, 0, 0, 0, 1, 33
"/mnt/dev/development/ostis/study/ostis/gt/Graphs/graph.concept.yaml", "YAML", 98, 0, 0, 0, 1, 99
"/mnt/dev/development/ostis/study/ostis/gt/Graphs/graph_structure.concept.yaml", "YAML", 94, 0, 0, 0, 2, 96
"/mnt/dev/development/ostis/study/ostis/gt/Graphs/graphs.domain.yaml", "YAML", 56, 0, 0, 0, 7, 63
"/mnt/dev/development/ostis/study/ostis/gt/Graphs/network.concept.yaml", "YAML", 56, 0, 0, 0, 1, 57
"/mnt/dev/development/ostis/study/ostis/gt/Graphs/null_graph.concept.yaml", "YAML", 42, 0, 0, 0, 1, 43
"/mnt/dev/development/ostis/study/ostis/gt/Graphs/pseudograph.concept.yaml", "YAML", 70, 0, 0, 0, 1, 71
"/mnt/dev/development/ostis/study/ostis/gt/Graphs/regular_graph.concept.yaml", "YAML", 75, 0, 0, 0, 1, 76
"/mnt/dev/development/ostis/study/ostis/gt/Graphs/simple_graph.concept.yaml", "YAML", 31, 0, 0, 0, 3, 34
"/mnt/dev/development/ostis/study/ostis/gt/Graphs/supergraph.concept.yaml", "YAML", 69, 0, 0, 0, 1, 70
"/mnt/dev/development/ostis/study/ostis/gt/Graphs/undirected_graph.concept.yaml", "YAML", 60, 0, 0, 0, 1, 61
"/mnt/dev/development/ostis/study/ostis/gt/Graphs/unweighted_graph.concept.yaml", "YAML", 109, 0, 0, 0, 1, 110
"/mnt/dev/development/ostis/study/ostis/gt/Graphs/vertex.concept.yaml", "YAML", 85, 0, 0, 0, 1, 86
"/mnt/dev/development/ostis/study/ostis/gt/Graphs/weighted_graph.concept.yaml", "YAML", 65, 0, 0, 0, 1, 66
"/mnt/dev/development/ostis/study/ostis/gt/README.md", "Markdown", 0, 0, 88, 0, 18, 106
"Total", "-", 11433, 16318, 102, 0, 4857, 32710